variant_id	marker_name	run_name	sequence_length	read_count	Tpos1_prerun	Tpos2_prerun	chimera_borderline	sequence
27	MFZR	prerun	181	564	237	327	False	actataccttatcttcgcagtattctcaggaatgctaggaactgcttttagtgttcttattcgaatggaactaacatctccaggtgtacaatacctacagggaaaccaccaactttacaatgtaatcattacagctcacgcattcctaatgatctttttcatggttatgccaggacttgtt
75	MFZR	prerun	175	587	318	269	False	actatattttatttttggggcttgatccggaatgctgggcacctctctaagccttctaattcgtgccgagctggggcacccgggttctttaattggcgacgatcaaatttacaatgtaatcgtcacagcccatgcttttattatgatttttttcatggttatgcctattataatc
96	MFZR	prerun	181	118	67	51	False	actctatttaatatttgctgcattttcaggggttataggaacaatattttctataattataagaatggaacttgcttatccaggtgatcaaatattgaatggtaatcaccaactttataatgttattgtaactgctcatgcatttgtaatgattttttttatggttatgcctgccttgatt
113	MFZR	prerun	181	153	85	68	False	actttatttcattttcggaacatttgcaggagttgtaggaactttactttcattatttattcgactagaattagcttatccaggaaatcaattttttttaggaaatcaccaactttataatgtggttgtgacagcacatgcttttatcatgatttttttcatggttatgccgattttaatc
125	MFZR	prerun	181	343	136	207	False	actttatttcattttcggaacatttgcaggagttgtaggaactttactttcattatttattcgtcttgaattagcttatccaggaaatcaattttttttaggaaatcaccaactttataatgtggttgtgacagcacatgcttttatcatgatttttttcatggttatgccgattttaatc
143	MFZR	prerun	175	41	0	41	False	actttattttattttcggagcgtggtcggggatggtaggcacatctctgagtcttttaattcgagccgaattgggtaatcctggttcactaattggggatgaccagatttacaacgttattgtaacagcccatgcttttattatgattttttttatagtaatgccaattatgatt
242	MFZR	prerun	175	3072	1641	1431	False	actttattttatttttggtgcttgatcaggaatagtaggaacttctttaagaattctaattcgagctgaattaggtcatgccggttcattaattggagatgatcaaatttataatgtaattgtaactgctcatgcttttgtaataattttctttatagttatacctattttaatt
318	MFZR	prerun	181	38	0	38	False	attatatttaatttttggtgctcttgctggagtaattggaactctattttctgtattaattagattacaattatcttacgctgattcaacagtacttcaaaataacagtcaattatacaatgttattgtaactgctcacgcatttgtaatgatattcttccttgtaatgcctgttcttatt
332	MFZR	prerun	178	357	188	169	False	attgtaccttatatttgccttattttcagggctattaggtactgctttttctgttttaataagacttgaattatcaggacctggtgtacaatacatagctgataaccaactttataacagtataattactgcacatgcaatacttatgattttcttcatggttatgcctgctatgata
390	MFZR	prerun	175	517	238	279	False	cctttatcttgtatttggtgcctgggccggaatggtagggaccgccctaagccttcttattcgggccgaactaagccagcctggctcgctattaggtgatagccaaatttataatgttattgttaccgcccacgccttcgtaataattttctttatagtcatgccaattctcatt
736	MFZR	prerun	175	35864	16351	19513	False	cctttattttattttcggtatctgatcaggtctcgtaggatcatcacttagatttattattcgaatagaattaagaactcctggtagatttattggcaacgaccaaatttataacgtaattgttacatctcatgcatttattataattttttttatagttataccaatcataatt
1076	MFZR	prerun	175	776	330	446	False	cttatattttatttttggtgcttgatcagggatagtgggaacttctttaagaattcttattcgagctgaacttggtcatgcgggatctttaatcggagacgatcaaatttacaatgtaattgttactgcacacgcctttgtaataattttttttatagttatacctattttaatt
1308	MFZR	prerun	175	9713	4273	5440	False	tctatatttcatttttggtgcttgggcaggtatggtaggtacctcattaagacttttaattcgagccgagttgggtaacccgggttcattaattggggacgatcaaatttataacgtaatcgtaactgctcatgcctttattatgattttttttatagtgatacctattataatt
1459	MFZR	prerun	181	33	33	0	False	tctttatattatttacggctttctcataggattggttggtacatttttttccgctgtcattcgtattcaactcatgtaccctggttcgttgtttttgggtggtaattaccattattataatactgtaattacagcgcacgcacttgtgataattttttttatggtcataccagtgttgatt
1535	MFZR	prerun	175	795	398	397	False	tttatatttcatttttggtgcatgatcaggtatggtgggtacttcccttagtttattaattcgagcagaacttggtaatcctggttctttgattggcgatgatcagatttataacgttattgtcactgcccatgcttttattatgattttttttatagtgatacctattataatt
1551	MFZR	prerun	175	206	49	157	False	tttatatttcatttttggtgcatgatcaggtatggtgggtacttcccttagtttattaattcgagcagaacttggtaatcctggttctttgattggtgatgatcagatttataacgttattgtcactgcccatgcttttattatgattttttttatagtgatacctattataatt
